.??????????????.????..........
.??????.??????.?.?????.??????.
.????????????..??.??????.????.
.?.....?????.?????.??.????.??.
.?.???.????.???????.?????????.
.?.???.?????.?????.????.??????
.?.???.??????.???.??....??????
.?.....????.??.?.???.??.??????
.????.?????????.????.??.??????
.???????????????????....??????
